111111111111111111111111111111111111111
100022000220003300000000002200220002201
100022000220000000000000002200220002201
100022000000000000000000222200220002201
100022222220000000000000220000220002201
100022000220000000000000220000220000001
100000000220000000000000000000220000001
100022000220002222220000000000000002201
100022000220002200022000000000220002201
100022000000000000002200000000220000001
100022222220000000002200000000220000001
100000000000000000000000000000000000001
111111113311111111441111111133111111111